iscrtati	V;PRS;NOM(1;SG)	iscrtam
šikljati	V;PRS;NOM(1;SG)	šikljam
izredati	V;PRS;NOM(1;SG)	izredam
ojačati	V;PRS;NOM(1;SG)	ojačam
vulgarizirati	V;PRS;NOM(1;SG)	vulgariziram
raskrinkati	V;PRS;NOM(1;SG)	raskrinkam
preneražavati	V;PRS;NOM(1;SG)	preneražavam
prodati	V;PRS;NOM(1;SG)	prodam
dremuckati	V;PRS;NOM(1;SG)	dremuckam
skicirati	V;PRS;NOM(1;SG)	skiciram
gluparati	V;PRS;NOM(1;SG)	gluparam
parati	V;PRS;NOM(1;SG)	param
događati	V;PRS;NOM(1;SG)	događam
pridodati	V;PRS;NOM(1;SG)	pridodam
natrpati	V;PRS;NOM(1;SG)	natrpam
istjerati	V;PRS;NOM(1;SG)	istjeram
habati	V;PRS;NOM(1;SG)	habam
patentirati	V;PRS;NOM(1;SG)	patentiram
slušati	V;PRS;NOM(1;SG)	slušam
etiketirati	V;PRS;NOM(1;SG)	etiketiram
klistirati	V;PRS;NOM(1;SG)	klistiram
nadvladati	V;PRS;NOM(1;SG)	nadvladam
iskušati	V;PRS;NOM(1;SG)	iskušam
šutirati	V;PRS;NOM(1;SG)	šutiram
dokidati	V;PRS;NOM(1;SG)	dokidam
izostavljati	V;PRS;NOM(1;SG)	izostavljam
verificirati	V;PRS;NOM(1;SG)	verificiram
drukati	V;PRS;NOM(1;SG)	drukam
ukomponirati	V;PRS;NOM(1;SG)	ukomponiram
gradirati	V;PRS;NOM(1;SG)	gradirem
ugađati	V;PRS;NOM(1;SG)	ugađam
inzistirati	V;PRS;NOM(1;SG)	inzistiram
skončavati	V;PRS;NOM(1;SG)	skončavam
iskuhavati	V;PRS;NOM(1;SG)	iskuhavam
prokartati	V;PRS;NOM(1;SG)	prokartam
odgajati	V;PRS;NOM(1;SG)	odgajam
testirati	V;PRS;NOM(1;SG)	testiram
spiritualizirati	V;PRS;NOM(1;SG)	spiritualiziram
mucati	V;PRS;NOM(1;SG)	mucam
diskreditirati	V;PRS;NOM(1;SG)	diskreditiram
buncati	V;PRS;NOM(1;SG)	buncam
propagirati	V;PRS;NOM(1;SG)	propagiram
rasprčkavati	V;PRS;NOM(1;SG)	rasprčkavam
blagoslivljati	V;PRS;NOM(1;SG)	blagoslivljam
natucati	V;PRS;NOM(1;SG)	natucam
dotiskati	V;PRS;NOM(1;SG)	dotiskam
izučavati	V;PRS;NOM(1;SG)	izučavam
pačati	V;PRS;NOM(1;SG)	pačam
prignati	V;PRS;NOM(1;SG)	prignam
nadimati	V;PRS;NOM(1;SG)	nadimam
indicirati	V;PRS;NOM(1;SG)	indiciram
nastupati	V;PRS;NOM(1;SG)	nastupam
oslobađati	V;PRS;NOM(1;SG)	oslobađam
kapkati	V;PRS;NOM(1;SG)	kapkam
isteturati	V;PRS;NOM(1;SG)	isteturam
robijati	V;PRS;NOM(1;SG)	robijam
majorizirati	V;PRS;NOM(1;SG)	majoriziram
ograničavati	V;PRS;NOM(1;SG)	ograničavam
koracati	V;PRS;NOM(1;SG)	koracam
kodificirati	V;PRS;NOM(1;SG)	kodificiram
legalizirati	V;PRS;NOM(1;SG)	legaliziram
odšuljati	V;PRS;NOM(1;SG)	odšuljam
mreškati	V;PRS;NOM(1;SG)	mreškam
poklapati	V;PRS;NOM(1;SG)	poklapam
čupati	V;PRS;NOM(1;SG)	čupam
savladati	V;PRS;NOM(1;SG)	savladam
zgrušati	V;PRS;NOM(1;SG)	zgrušam
očupati	V;PRS;NOM(1;SG)	očupam
rešetati	V;PRS;NOM(1;SG)	rešetam
okrivljavati	V;PRS;NOM(1;SG)	okrivljujem
komentirati	V;PRS;NOM(1;SG)	komentiram
ispitati	V;PRS;NOM(1;SG)	ispitam
šmrcati	V;PRS;NOM(1;SG)	šmrcam
prikrpati	V;PRS;NOM(1;SG)	prikrpam
odvijati	V;PRS;NOM(1;SG)	odvijam
ispeljati	V;PRS;NOM(1;SG)	ispeljam
nukati	V;PRS;NOM(1;SG)	nukam
deverati	V;PRS;NOM(1;SG)	deverem
petljati	V;PRS;NOM(1;SG)	petljam
razigrati	V;PRS;NOM(1;SG)	razigram
participirati	V;PRS;NOM(1;SG)	participiram
nalijevati	V;PRS;NOM(1;SG)	nalijevam
rascjepkavati	V;PRS;NOM(1;SG)	rascjepkavam
osposobljavati	V;PRS;NOM(1;SG)	osposobljavam
funkcionirati	V;PRS;NOM(1;SG)	funkcioniram
iskradati	V;PRS;NOM(1;SG)	iskradam
natrljati	V;PRS;NOM(1;SG)	natrljam
dijagnosticirati	V;PRS;NOM(1;SG)	dijagnosticiram
zamatati	V;PRS;NOM(1;SG)	zamatam
zapucati	V;PRS;NOM(1;SG)	zapucam
oživljavati	V;PRS;NOM(1;SG)	oživljavam
ovijati	V;PRS;NOM(1;SG)	ovijam
prognati	V;PRS;NOM(1;SG)	prognam
išamarati	V;PRS;NOM(1;SG)	išamaram
zapošljavati	V;PRS;NOM(1;SG)	zapošljavam
razmotavati	V;PRS;NOM(1;SG)	razmotavam
psihologizirati	V;PRS;NOM(1;SG)	psihologiziram
subordinirati	V;PRS;NOM(1;SG)	subordiniram
nagovještavati	V;PRS;NOM(1;SG)	nagovještavam
iskoprcati	V;PRS;NOM(1;SG)	iskoprcam
panirati	V;PRS;NOM(1;SG)	paniram
batrgati	V;PRS;NOM(1;SG)	batrgam
uvećavati	V;PRS;NOM(1;SG)	uvećavam
podragati	V;PRS;NOM(1;SG)	podragam
citirati	V;PRS;NOM(1;SG)	citiram
istupati	V;PRS;NOM(1;SG)	istupam
ispaštati	V;PRS;NOM(1;SG)	ispaštam
locirati	V;PRS;NOM(1;SG)	lociram
šljakati	V;PRS;NOM(1;SG)	šljakam
dodvoravati	V;PRS;NOM(1;SG)	dodvoravam
smatrati	V;PRS;NOM(1;SG)	smatram
parirati	V;PRS;NOM(1;SG)	pariram
oskudijevati	V;PRS;NOM(1;SG)	oskudijevam
štopati	V;PRS;NOM(1;SG)	štopam
oribati	V;PRS;NOM(1;SG)	oribam
namotati	V;PRS;NOM(1;SG)	namotam
olakšavati	V;PRS;NOM(1;SG)	olakšavam
izudarati	V;PRS;NOM(1;SG)	izudaram
perpetuirati	V;PRS;NOM(1;SG)	perpetuiram
posipati	V;PRS;NOM(1;SG)	posipam
pripovijedati	V;PRS;NOM(1;SG)	pripovijedam
dezinficirati	V;PRS;NOM(1;SG)	dezinficiram
odbijati	V;PRS;NOM(1;SG)	odbijam
podraškati	V;PRS;NOM(1;SG)	podraškam
klijati	V;PRS;NOM(1;SG)	klijam
krzmati	V;PRS;NOM(1;SG)	krzmam
biti	V;PRS;NOM(1;SG)	bim
tužakati	V;PRS;NOM(1;SG)	tužačem
pipati	V;PRS;NOM(1;SG)	pipam
salutirati	V;PRS;NOM(1;SG)	salutiram
začaravati	V;PRS;NOM(1;SG)	začaravam
istrljati	V;PRS;NOM(1;SG)	istrljam
sastajati	V;PRS;NOM(1;SG)	sastajem
saznati	V;PRS;NOM(1;SG)	saznam
kukičati	V;PRS;NOM(1;SG)	kukičam
obećavati	V;PRS;NOM(1;SG)	obećavam
konceptualizirati	V;PRS;NOM(1;SG)	konceptualiziram
pregovarati	V;PRS;NOM(1;SG)	pregovaram
ribati	V;PRS;NOM(1;SG)	ribam
upoznati	V;PRS;NOM(1;SG)	upoznam
rješavati	V;PRS;NOM(1;SG)	rješavam
prskati	V;PRS;NOM(1;SG)	prskam
isparivati	V;PRS;NOM(1;SG)	isparujem
pljeskati	V;PRS;NOM(1;SG)	pljeskam
pozatvarati	V;PRS;NOM(1;SG)	pozatvaram
naguravati	V;PRS;NOM(1;SG)	naguravam
centralizirati	V;PRS;NOM(1;SG)	centraliziram
zbrzati	V;PRS;NOM(1;SG)	zbrzam
žacati	V;PRS;NOM(1;SG)	žacam
mozgati	V;PRS;NOM(1;SG)	mozgam
otežavati	V;PRS;NOM(1;SG)	otežavam
prolongirati	V;PRS;NOM(1;SG)	prolongiram
raštrkati	V;PRS;NOM(1;SG)	raštrkam
pripadati	V;PRS;NOM(1;SG)	pripadam
legitimirati	V;PRS;NOM(1;SG)	legitimiram
razmatrati	V;PRS;NOM(1;SG)	razmatram
ošišati	V;PRS;NOM(1;SG)	ošišam
lemati	V;PRS;NOM(1;SG)	lemam
ukalkulirati	V;PRS;NOM(1;SG)	ukalkuliram
išibati	V;PRS;NOM(1;SG)	išibam
projektirati	V;PRS;NOM(1;SG)	projektiram
perforirati	V;PRS;NOM(1;SG)	perforiram
osporavati	V;PRS;NOM(1;SG)	osporavam
intervjuirati	V;PRS;NOM(1;SG)	intervjuiram
zaustavljati	V;PRS;NOM(1;SG)	zaustavljam
varati	V;PRS;NOM(1;SG)	varam
porađati	V;PRS;NOM(1;SG)	porađam
drenirati	V;PRS;NOM(1;SG)	dreniram
razbrbljati	V;PRS;NOM(1;SG)	razbrbljam
izbjegavati	V;PRS;NOM(1;SG)	izbjegavam
raspakirati	V;PRS;NOM(1;SG)	raspakiram
obzidati	V;PRS;NOM(1;SG)	obzidam
nabijati	V;PRS;NOM(1;SG)	nabijam
uviđati	V;PRS;NOM(1;SG)	uviđam
emitirati	V;PRS;NOM(1;SG)	emitiram
simpatizirati	V;PRS;NOM(1;SG)	simpatiziram
domišljati	V;PRS;NOM(1;SG)	domišljam
spočitavati	V;PRS;NOM(1;SG)	spočitavam
pokidati	V;PRS;NOM(1;SG)	pokidam
muljati	V;PRS;NOM(1;SG)	muljam
kastrirati	V;PRS;NOM(1;SG)	kastriram
volontirati	V;PRS;NOM(1;SG)	volontiram
rasipati	V;PRS;NOM(1;SG)	rasipam
snimati	V;PRS;NOM(1;SG)	snimam
razbacati	V;PRS;NOM(1;SG)	razbacam
paginirati	V;PRS;NOM(1;SG)	paginiram
razvrgavati	V;PRS;NOM(1;SG)	razvrgavam
posvajati	V;PRS;NOM(1;SG)	posvajam
proskribirati	V;PRS;NOM(1;SG)	proskribiram
nahodati	V;PRS;NOM(1;SG)	nahodam
ojačavati	V;PRS;NOM(1;SG)	ojačavam
pucketati	V;PRS;NOM(1;SG)	pucketam
terorizirati	V;PRS;NOM(1;SG)	teroriziram
uljepšavati	V;PRS;NOM(1;SG)	uljepšavam
senzibilizirati	V;PRS;NOM(1;SG)	senzibiliziram
izgustirati	V;PRS;NOM(1;SG)	izgustiram
ojkati	V;PRS;NOM(1;SG)	ojkam
kombinirati	V;PRS;NOM(1;SG)	kombiniram
podlokavati	V;PRS;NOM(1;SG)	podlokavam
nagruvati	V;PRS;NOM(1;SG)	nagruvam
divergirati	V;PRS;NOM(1;SG)	divergiram
probavljati	V;PRS;NOM(1;SG)	probavljam
lelujati	V;PRS;NOM(1;SG)	lelujam
odmotati	V;PRS;NOM(1;SG)	odmotam
špartati	V;PRS;NOM(1;SG)	špartam
kartati	V;PRS;NOM(1;SG)	kartam
karati	V;PRS;NOM(1;SG)	karam
aterirati	V;PRS;NOM(1;SG)	ateriram
svrdlati	V;PRS;NOM(1;SG)	svrdlam
ispripovijedati	V;PRS;NOM(1;SG)	ispripovijedam
dodijati	V;PRS;NOM(1;SG)	dodijam
drljati	V;PRS;NOM(1;SG)	drljam
saslušati	V;PRS;NOM(1;SG)	saslušam
dozvoljavati	V;PRS;NOM(1;SG)	dozvoljavam
dragati	V;PRS;NOM(1;SG)	dragam
paktirati	V;PRS;NOM(1;SG)	paktiram
udvarati	V;PRS;NOM(1;SG)	udvaram
nabadati	V;PRS;NOM(1;SG)	nabadam
urbanizirati	V;PRS;NOM(1;SG)	urbaniziram
opričati	V;PRS;NOM(1;SG)	opričam
batinati	V;PRS;NOM(1;SG)	batinam
šakati	V;PRS;NOM(1;SG)	šačem
polupati	V;PRS;NOM(1;SG)	polupam
djelati	V;PRS;NOM(1;SG)	djelam
iskrcati	V;PRS;NOM(1;SG)	iskrcam
ispravljati	V;PRS;NOM(1;SG)	ispravljam
skzhati	V;PRS;NOM(1;SG)	skzšem
tornjati	V;PRS;NOM(1;SG)	tornjam
šarmirati	V;PRS;NOM(1;SG)	šarmiram
iskonstruirati	V;PRS;NOM(1;SG)	iskonstruiram
namještati	V;PRS;NOM(1;SG)	namještam
prakticirati	V;PRS;NOM(1;SG)	prakticiram
maltretirati	V;PRS;NOM(1;SG)	maltretiram
golicati	V;PRS;NOM(1;SG)	goličem
rondati	V;PRS;NOM(1;SG)	rondam
vraćati	V;PRS;NOM(1;SG)	vraćam
podbadati	V;PRS;NOM(1;SG)	podbadam
ukoravati	V;PRS;NOM(1;SG)	ukoravam
bonitirati	V;PRS;NOM(1;SG)	bonitiram
zagledati	V;PRS;NOM(1;SG)	zagledam
mobilizirati	V;PRS;NOM(1;SG)	mobiliziram
prišuljati	V;PRS;NOM(1;SG)	prišuljam
pomiješati	V;PRS;NOM(1;SG)	pomiješam
priopćiti	V;PRS;NOM(1;SG)	priopćim
nasaditi	V;PRS;NOM(1;SG)	nasadim
uvažiti	V;PRS;NOM(1;SG)	uvažim
odrubiti	V;PRS;NOM(1;SG)	odrubim
ukotviti	V;PRS;NOM(1;SG)	ukotvim
izlijepiti	V;PRS;NOM(1;SG)	izlijepim
preložiti	V;PRS;NOM(1;SG)	preložim
dojiti	V;PRS;NOM(1;SG)	dojim
pobilježiti	V;PRS;NOM(1;SG)	pobilježim
proknjižiti	V;PRS;NOM(1;SG)	proknjižim
zacrvenjeti	V;PRS;NOM(1;SG)	zacrvenim
pobaciti	V;PRS;NOM(1;SG)	pobacim
ukipiti	V;PRS;NOM(1;SG)	ukipim
uniziti	V;PRS;NOM(1;SG)	unizim
slijediti	V;PRS;NOM(1;SG)	slijedim
dopustiti	V;PRS;NOM(1;SG)	dopustsem
skrutiti	V;PRS;NOM(1;SG)	skrutmem
bušiti	V;PRS;NOM(1;SG)	bušim
grmjeti	V;PRS;NOM(1;SG)	grmim
namagarčiti	V;PRS;NOM(1;SG)	namagarčim
tuliti	V;PRS;NOM(1;SG)	tulim
zahiriti	V;PRS;NOM(1;SG)	zahirim
izglaviti	V;PRS;NOM(1;SG)	izglavim
teretiti	V;PRS;NOM(1;SG)	teretim
opismeniti	V;PRS;NOM(1;SG)	opismenim
rušiti	V;PRS;NOM(1;SG)	rušim
izjaloviti	V;PRS;NOM(1;SG)	izjalovim
zakrviti	V;PRS;NOM(1;SG)	zakrvim
razmotriti	V;PRS;NOM(1;SG)	razmotrim
kršiti	V;PRS;NOM(1;SG)	kršim
hvaliti	V;PRS;NOM(1;SG)	hvalim
podijeliti	V;PRS;NOM(1;SG)	podijelim
najaviti	V;PRS;NOM(1;SG)	najavim
pridružiti	V;PRS;NOM(1;SG)	pridružim
ušoriti	V;PRS;NOM(1;SG)	ušorim
vrijediti	V;PRS;NOM(1;SG)	vrijedim
istrošiti	V;PRS;NOM(1;SG)	istrošim
kratiti	V;PRS;NOM(1;SG)	kratim
šištati	V;PRS;NOM(1;SG)	šištam
resiti	V;PRS;NOM(1;SG)	resim
nadograditi	V;PRS;NOM(1;SG)	nadogradim
hapsiti	V;PRS;NOM(1;SG)	hapsim
raspoložiti	V;PRS;NOM(1;SG)	raspoložim
ožednjeti	V;PRS;NOM(1;SG)	ožednem
razletjeti	V;PRS;NOM(1;SG)	razletjmem
pobrojati	V;PRS;NOM(1;SG)	pobrojam
staviti	V;PRS;NOM(1;SG)	stavim
žudjeti	V;PRS;NOM(1;SG)	žudim
zahvaliti	V;PRS;NOM(1;SG)	zahvalim
uresiti	V;PRS;NOM(1;SG)	uresim
lemiti	V;PRS;NOM(1;SG)	lemim
kititi	V;PRS;NOM(1;SG)	kitim
zarušiti	V;PRS;NOM(1;SG)	zarušim
pohoditi	V;PRS;NOM(1;SG)	pohodim
nastaviti	V;PRS;NOM(1;SG)	nastavim
zasvjedočiti	V;PRS;NOM(1;SG)	zasvjedočim
odmjeriti	V;PRS;NOM(1;SG)	odmjerim
omasoviti	V;PRS;NOM(1;SG)	omasovim
svrbjeti	V;PRS;NOM(1;SG)	svrbim
utoliti	V;PRS;NOM(1;SG)	utolim
brujati	V;PRS;NOM(1;SG)	brujam
nataložiti	V;PRS;NOM(1;SG)	nataložim
pregaziti	V;PRS;NOM(1;SG)	pregazim
zapuniti	V;PRS;NOM(1;SG)	zapunim
kilaviti	V;PRS;NOM(1;SG)	kilavim
ozloglasiti	V;PRS;NOM(1;SG)	ozloglasim
iskositi	V;PRS;NOM(1;SG)	iskosim
krpiti	V;PRS;NOM(1;SG)	krpim
isprositi	V;PRS;NOM(1;SG)	isprosim
prekupiti	V;PRS;NOM(1;SG)	prekupim
ukorijeniti	V;PRS;NOM(1;SG)	ukorijenim
pridržati	V;PRS;NOM(1;SG)	pridržam
ocariniti	V;PRS;NOM(1;SG)	ocarinim
ucviliti	V;PRS;NOM(1;SG)	ucvilim
naslijediti	V;PRS;NOM(1;SG)	naslijedim
spariti	V;PRS;NOM(1;SG)	sparim
isprazniti	V;PRS;NOM(1;SG)	ispraznim
nagliti	V;PRS;NOM(1;SG)	naglim
krvariti	V;PRS;NOM(1;SG)	krvarim
naperiti	V;PRS;NOM(1;SG)	naperim
paliti	V;PRS;NOM(1;SG)	palim
omeđiti	V;PRS;NOM(1;SG)	omeđim
kamčiti	V;PRS;NOM(1;SG)	kamčim
razdijeliti	V;PRS;NOM(1;SG)	razdijelim
pratiti	V;PRS;NOM(1;SG)	pratim
živjeti	V;PRS;NOM(1;SG)	živim
zagustiti	V;PRS;NOM(1;SG)	zagustim
oštetiti	V;PRS;NOM(1;SG)	oštetmem
proizlaziti	V;PRS;NOM(1;SG)	proizlazim
iskorijeniti	V;PRS;NOM(1;SG)	iskorijenim
sklopiti	V;PRS;NOM(1;SG)	sklopim
pješačiti	V;PRS;NOM(1;SG)	pješačim
spasiti	V;PRS;NOM(1;SG)	spasim
okupiti	V;PRS;NOM(1;SG)	okupim
uozbiljiti	V;PRS;NOM(1;SG)	uozbiljim
uspaliti	V;PRS;NOM(1;SG)	uspalim
dogotoviti	V;PRS;NOM(1;SG)	dogotovim
zapjeniti	V;PRS;NOM(1;SG)	zapjenim
zavlačiti	V;PRS;NOM(1;SG)	zavlačim
naturiti	V;PRS;NOM(1;SG)	naturim
kasniti	V;PRS;NOM(1;SG)	kasnim
pomoriti	V;PRS;NOM(1;SG)	pomorim
prelomiti	V;PRS;NOM(1;SG)	prelomim
pošašaviti	V;PRS;NOM(1;SG)	pošašavim
kalemiti	V;PRS;NOM(1;SG)	kalemim
naseliti	V;PRS;NOM(1;SG)	naselim
okaniti	V;PRS;NOM(1;SG)	okanim
uslišiti	V;PRS;NOM(1;SG)	uslišim
prikratiti	V;PRS;NOM(1;SG)	prikratim
prehraniti	V;PRS;NOM(1;SG)	prehranim
popustiti	V;PRS;NOM(1;SG)	popustsem
posrebriti	V;PRS;NOM(1;SG)	posrebrim
osiromašiti	V;PRS;NOM(1;SG)	osiromašim
zamijetiti	V;PRS;NOM(1;SG)	zamijetim
poraditi	V;PRS;NOM(1;SG)	poradim
raspremiti	V;PRS;NOM(1;SG)	raspremim
ojaditi	V;PRS;NOM(1;SG)	ojadim
ishitriti	V;PRS;NOM(1;SG)	ishitrim
kalupiti	V;PRS;NOM(1;SG)	kalupim
pariti	V;PRS;NOM(1;SG)	parim
mastiti	V;PRS;NOM(1;SG)	mastim
zuriti	V;PRS;NOM(1;SG)	zurim
toviti	V;PRS;NOM(1;SG)	tovim
zgaziti	V;PRS;NOM(1;SG)	zgazim
pogaziti	V;PRS;NOM(1;SG)	pogazim
sukobiti	V;PRS;NOM(1;SG)	sukobim
održati	V;PRS;NOM(1;SG)	održam
urediti	V;PRS;NOM(1;SG)	uredim
optočiti	V;PRS;NOM(1;SG)	optočim
graditi	V;PRS;NOM(1;SG)	gradim
odseliti	V;PRS;NOM(1;SG)	odselim
bogoraditi	V;PRS;NOM(1;SG)	bogoradim
kotiti	V;PRS;NOM(1;SG)	kotim
porubiti	V;PRS;NOM(1;SG)	porubim
zasniježiti	V;PRS;NOM(1;SG)	zasniježim
glušiti	V;PRS;NOM(1;SG)	glušim
izmožditi	V;PRS;NOM(1;SG)	izmoždim
mokriti	V;PRS;NOM(1;SG)	mokrim
prikupiti	V;PRS;NOM(1;SG)	prikupim
izmučiti	V;PRS;NOM(1;SG)	izmučim
smutiti	V;PRS;NOM(1;SG)	smutmem
ježiti	V;PRS;NOM(1;SG)	ježim
usmrtiti	V;PRS;NOM(1;SG)	usmrtim
gladiti	V;PRS;NOM(1;SG)	gladim
telaliti	V;PRS;NOM(1;SG)	telalim
krijumčariti	V;PRS;NOM(1;SG)	krijumčarim
opaliti	V;PRS;NOM(1;SG)	opalim
krpariti	V;PRS;NOM(1;SG)	krparim
zablatiti	V;PRS;NOM(1;SG)	zablatim
nagrabiti	V;PRS;NOM(1;SG)	nagrabim
skužiti	V;PRS;NOM(1;SG)	skužim
preplaviti	V;PRS;NOM(1;SG)	preplavim
cmizdriti	V;PRS;NOM(1;SG)	cmizdrim
zagospodariti	V;PRS;NOM(1;SG)	zagospodarim
jutriti	V;PRS;NOM(1;SG)	jutrim
preplašiti	V;PRS;NOM(1;SG)	preplašim
tražiti	V;PRS;NOM(1;SG)	tražim
kružiti	V;PRS;NOM(1;SG)	kružim
dodijeliti	V;PRS;NOM(1;SG)	dodijelim
isključiti	V;PRS;NOM(1;SG)	isključim
prisiliti	V;PRS;NOM(1;SG)	prisilim
poludjeti	V;PRS;NOM(1;SG)	poludim
izostaviti	V;PRS;NOM(1;SG)	izostavim
kriviti	V;PRS;NOM(1;SG)	krivim
grstiti	V;PRS;NOM(1;SG)	grstim
porazmjestiti	V;PRS;NOM(1;SG)	porazmjestim
zaobilaziti	V;PRS;NOM(1;SG)	zaobilazim
zagušiti	V;PRS;NOM(1;SG)	zagušim
razglasiti	V;PRS;NOM(1;SG)	razglasim
štetiti	V;PRS;NOM(1;SG)	štetmem
rashladiti	V;PRS;NOM(1;SG)	rashladim
zagraditi	V;PRS;NOM(1;SG)	zagradim
zabrtviti	V;PRS;NOM(1;SG)	zabrtvim
priskočiti	V;PRS;NOM(1;SG)	priskočim
zaprašiti	V;PRS;NOM(1;SG)	zaprašim
krstariti	V;PRS;NOM(1;SG)	krstarim
poraziti	V;PRS;NOM(1;SG)	porazim
zatreperiti	V;PRS;NOM(1;SG)	zatreperim
kupiti	V;PRS;NOM(1;SG)	kupim
spremiti	V;PRS;NOM(1;SG)	spremim
mandaliti	V;PRS;NOM(1;SG)	mandalim
zamijesiti	V;PRS;NOM(1;SG)	zamijesim
pregrmjeti	V;PRS;NOM(1;SG)	pregrmim
prštati	V;PRS;NOM(1;SG)	prštam
pokupiti	V;PRS;NOM(1;SG)	pokupim
pospješiti	V;PRS;NOM(1;SG)	pospješim
usplahiriti	V;PRS;NOM(1;SG)	usplahirim
prevaliti	V;PRS;NOM(1;SG)	prevalim
grubjeti	V;PRS;NOM(1;SG)	grubim
izdovoljiti	V;PRS;NOM(1;SG)	izdovoljim
nauditi	V;PRS;NOM(1;SG)	naudim
prigrliti	V;PRS;NOM(1;SG)	prigrlim
izmjeniti	V;PRS;NOM(1;SG)	izmjenim
oličiti	V;PRS;NOM(1;SG)	oličim
iskupiti	V;PRS;NOM(1;SG)	iskupim
pomiriti	V;PRS;NOM(1;SG)	pomirim
usrećiti	V;PRS;NOM(1;SG)	usrećim
žlijebiti	V;PRS;NOM(1;SG)	žlijebim
vrtjeti	V;PRS;NOM(1;SG)	vrtim
zasoliti	V;PRS;NOM(1;SG)	zasolim
pretpostaviti	V;PRS;NOM(1;SG)	pretpostavim
poslaveniti	V;PRS;NOM(1;SG)	poslavenim
podroniti	V;PRS;NOM(1;SG)	podronim
zakočiti	V;PRS;NOM(1;SG)	zakočim
sroditi	V;PRS;NOM(1;SG)	srodim
zlorabiti	V;PRS;NOM(1;SG)	zlorabim
prirediti	V;PRS;NOM(1;SG)	priredim
izvrtjeti	V;PRS;NOM(1;SG)	izvrtim
zakriviti	V;PRS;NOM(1;SG)	zakrivim
letjeti	V;PRS;NOM(1;SG)	letim
cijeniti	V;PRS;NOM(1;SG)	cijenim
odroniti	V;PRS;NOM(1;SG)	odronim
srediti	V;PRS;NOM(1;SG)	sredim
primjeriti	V;PRS;NOM(1;SG)	primjerim
bubriti	V;PRS;NOM(1;SG)	bubrim
mlatiti	V;PRS;NOM(1;SG)	mlatim
ležati	V;PRS;NOM(1;SG)	ležam
povaliti	V;PRS;NOM(1;SG)	povalim
iskoračiti	V;PRS;NOM(1;SG)	iskoračim
razbuditi	V;PRS;NOM(1;SG)	razbudim
javiti	V;PRS;NOM(1;SG)	javim
prozujati	V;PRS;NOM(1;SG)	prozujam
žuljati	V;PRS;NOM(1;SG)	žuljam
poriti	V;PRS;NOM(1;SG)	porim
potrčati	V;PRS;NOM(1;SG)	potrčam
nakititi	V;PRS;NOM(1;SG)	nakitim
knjižiti	V;PRS;NOM(1;SG)	knjižim
prolomiti	V;PRS;NOM(1;SG)	prolomim
prekrižiti	V;PRS;NOM(1;SG)	prekrižim
okopnjeti	V;PRS;NOM(1;SG)	okopnjmem
istiještiti	V;PRS;NOM(1;SG)	istiještim
protusloviti	V;PRS;NOM(1;SG)	protuslovim
vjetriti	V;PRS;NOM(1;SG)	vjetrim
uraniti	V;PRS;NOM(1;SG)	uranim
povlačiti	V;PRS;NOM(1;SG)	povlačim
podmazivati	V;PRS;NOM(1;SG)	podmazujem
oduljivati	V;PRS;NOM(1;SG)	oduljivam
zavrbovati	V;PRS;NOM(1;SG)	zavrbujem
nasmijati	V;PRS;NOM(1;SG)	nasmijam
otvrdnjivati	V;PRS;NOM(1;SG)	otvrdnjujem
snužđivati	V;PRS;NOM(1;SG)	snužđujem
zgrijati	V;PRS;NOM(1;SG)	zgrijem
kumovati	V;PRS;NOM(1;SG)	kumujem
ismijati	V;PRS;NOM(1;SG)	ismijam
objelodanjivati	V;PRS;NOM(1;SG)	objelodanjujem
obavješćivati	V;PRS;NOM(1;SG)	obavješćujem
naviti	V;PRS;NOM(1;SG)	navim
povjerovati	V;PRS;NOM(1;SG)	povjerujem
ocrnjivati	V;PRS;NOM(1;SG)	ocrnjujem
posijati	V;PRS;NOM(1;SG)	posijem
iskupljivati	V;PRS;NOM(1;SG)	iskupljujem
otpočinjati	V;PRS;NOM(1;SG)	otpočinjem
razdraživati	V;PRS;NOM(1;SG)	razdražujem
saznavati	V;PRS;NOM(1;SG)	saznajem
prosjajivati	V;PRS;NOM(1;SG)	prosjajujem
potrovati	V;PRS;NOM(1;SG)	potrojem
uklješćivati	V;PRS;NOM(1;SG)	uklješćujem
zakrčivati	V;PRS;NOM(1;SG)	zakrčujem
urezivati	V;PRS;NOM(1;SG)	urezivam
prijateljevati	V;PRS;NOM(1;SG)	prijateljujem
obrazovati	V;PRS;NOM(1;SG)	obrazujem
ispuhivati	V;PRS;NOM(1;SG)	ispuhujem
prokapljivati	V;PRS;NOM(1;SG)	prokapljujem
dopisivati	V;PRS;NOM(1;SG)	dopisujem
pogodovati	V;PRS;NOM(1;SG)	pogodujem
izrugivati	V;PRS;NOM(1;SG)	izrugujem
isušivati	V;PRS;NOM(1;SG)	isušujem
učlanjivati	V;PRS;NOM(1;SG)	učlanjujem
prerezivati	V;PRS;NOM(1;SG)	prerezivam
žalovati	V;PRS;NOM(1;SG)	žalujem
stupnjevati	V;PRS;NOM(1;SG)	stupnjevam
raširivati	V;PRS;NOM(1;SG)	raširujem
dokazivati	V;PRS;NOM(1;SG)	dokazujem
doimati	V;PRS;NOM(1;SG)	doimam
promašivati	V;PRS;NOM(1;SG)	promašujem
zaprepašćivati	V;PRS;NOM(1;SG)	zaprepašćujem
priskrbljivati	V;PRS;NOM(1;SG)	priskrbljujem
napinjati	V;PRS;NOM(1;SG)	napinjem
smanjivati	V;PRS;NOM(1;SG)	smanjujem
skrućivati	V;PRS;NOM(1;SG)	skrućujem
ograđivati	V;PRS;NOM(1;SG)	ograđujem
razjarivati	V;PRS;NOM(1;SG)	razjarujem
načuti	V;PRS;NOM(1;SG)	načujem
pouzdavati	V;PRS;NOM(1;SG)	pouzdavam
smućivati	V;PRS;NOM(1;SG)	smućujem
sniti	V;PRS;NOM(1;SG)	snim
odliti	V;PRS;NOM(1;SG)	odlim
trgovati	V;PRS;NOM(1;SG)	trgujem
objavljivati	V;PRS;NOM(1;SG)	objavljujem
zaglupljivati	V;PRS;NOM(1;SG)	zaglupljujem
utrkivati	V;PRS;NOM(1;SG)	utrkujem
zabiti	V;PRS;NOM(1;SG)	zabim
dograđivati	V;PRS;NOM(1;SG)	dograđujem
ispsovati	V;PRS;NOM(1;SG)	ispsujem
uznapredovati	V;PRS;NOM(1;SG)	uznapredujem
zaobljivati	V;PRS;NOM(1;SG)	zaobljujem
ukoričivati	V;PRS;NOM(1;SG)	ukoričijem
gostovati	V;PRS;NOM(1;SG)	gostujem
oviti	V;PRS;NOM(1;SG)	ovim
zamračivati	V;PRS;NOM(1;SG)	zamračujem
ustrajati	V;PRS;NOM(1;SG)	ustrajem
podnapiti	V;PRS;NOM(1;SG)	podnapijem
izrađivati	V;PRS;NOM(1;SG)	izrađujem
izduživati	V;PRS;NOM(1;SG)	izdužujem
zaređivati	V;PRS;NOM(1;SG)	zaređujem
pristajati	V;PRS;NOM(1;SG)	pristajem
potvrđivati	V;PRS;NOM(1;SG)	potvrđujem
božićevati	V;PRS;NOM(1;SG)	božićevam
natkriti	V;PRS;NOM(1;SG)	natkrijem
prekovati	V;PRS;NOM(1;SG)	prekujem
nahrupljivati	V;PRS;NOM(1;SG)	nahrupljujem
začuti	V;PRS;NOM(1;SG)	začujem
hukati	V;PRS;NOM(1;SG)	hukam
šmrknuti	V;PRS;NOM(1;SG)	šmrknem
nadići	V;PRS;NOM(1;SG)	nadiđem
isklesati	V;PRS;NOM(1;SG)	isklešem
zabosti	V;PRS;NOM(1;SG)	zabodem
zderati	V;PRS;NOM(1;SG)	zderem
poodmaći	V;PRS;NOM(1;SG)	poodmaknem
dopirati	V;PRS;NOM(1;SG)	dopiram
okretati	V;PRS;NOM(1;SG)	okrećem
susresti	V;PRS;NOM(1;SG)	susretnem
obrecnuti	V;PRS;NOM(1;SG)	obrecnem
umirati	V;PRS;NOM(1;SG)	umiram
iščeznuti	V;PRS;NOM(1;SG)	iščeznem
prozepsti	V;PRS;NOM(1;SG)	prozebem
umuknuti	V;PRS;NOM(1;SG)	umuknem
gakati	V;PRS;NOM(1;SG)	gačem
prozirati	V;PRS;NOM(1;SG)	proziram
ukinuti	V;PRS;NOM(1;SG)	ukinem
ruknuti	V;PRS;NOM(1;SG)	ruknem
ljutnuti	V;PRS;NOM(1;SG)	ljutnem
ispolagati	V;PRS;NOM(1;SG)	ispolažem
sklonuti	V;PRS;NOM(1;SG)	sklonem
zavući	V;PRS;NOM(1;SG)	zavučem
polizati	V;PRS;NOM(1;SG)	poližem
pripisati	V;PRS;NOM(1;SG)	pripišem
odjahati	V;PRS;NOM(1;SG)	odjašem
izdupsti	V;PRS;NOM(1;SG)	izdubnem
posrati	V;PRS;NOM(1;SG)	poserem
podlegnuti	V;PRS;NOM(1;SG)	podliježem
odgristi	V;PRS;NOM(1;SG)	odgrizem
požderati	V;PRS;NOM(1;SG)	požderem
naviknuti	V;PRS;NOM(1;SG)	navičem
proždirati	V;PRS;NOM(1;SG)	proždiram
odrezati	V;PRS;NOM(1;SG)	odrežem
izmusti	V;PRS;NOM(1;SG)	izmudem
ždrijeti	V;PRS;NOM(1;SG)	ždrem
odahnuti	V;PRS;NOM(1;SG)	odahnem
domahnuti	V;PRS;NOM(1;SG)	domahnem
prikrasti	V;PRS;NOM(1;SG)	prikradem
zagrcnuti	V;PRS;NOM(1;SG)	zagrcnem
zasjeći	V;PRS;NOM(1;SG)	zasječem
zadići	V;PRS;NOM(1;SG)	zadiđem
zavrtati	V;PRS;NOM(1;SG)	zavrćem
iskati	V;PRS;NOM(1;SG)	iskam
zastrijeti	V;PRS;NOM(1;SG)	zastrem
frktati	V;PRS;NOM(1;SG)	frkćem
zazirati	V;PRS;NOM(1;SG)	zaziram
drznuti	V;PRS;NOM(1;SG)	drznem
uvirati	V;PRS;NOM(1;SG)	uviram
prometati	V;PRS;NOM(1;SG)	prometam
izbrisati	V;PRS;NOM(1;SG)	izbrišem
stresti	V;PRS;NOM(1;SG)	stresem
pregristi	V;PRS;NOM(1;SG)	pregrizem
smaknuti	V;PRS;NOM(1;SG)	smaknem
otjecati	V;PRS;NOM(1;SG)	otječem
musti	V;PRS;NOM(1;SG)	mudem
cvrcnuti	V;PRS;NOM(1;SG)	cvrcnem
otesati	V;PRS;NOM(1;SG)	otesam
vinuti	V;PRS;NOM(1;SG)	vinem
isplakati	V;PRS;NOM(1;SG)	isplačem
dokinuti	V;PRS;NOM(1;SG)	dokinem
dotaći	V;PRS;NOM(1;SG)	dotaknem
nalijegati	V;PRS;NOM(1;SG)	nalijegam
izvući	V;PRS;NOM(1;SG)	izvučem
sapeti	V;PRS;NOM(1;SG)	sapnem
nadoći	V;PRS;NOM(1;SG)	nadođem
priteći	V;PRS;NOM(1;SG)	priteknem
umrijeti	V;PRS;NOM(1;SG)	umirem
razrasti	V;PRS;NOM(1;SG)	razrastem
nagristi	V;PRS;NOM(1;SG)	nagrizem
potpisati	V;PRS;NOM(1;SG)	potpišem
izvesti	V;PRS;NOM(1;SG)	izvedem
iskrasti	V;PRS;NOM(1;SG)	iskradem
odgonetnuti	V;PRS;NOM(1;SG)	odgonetnem
odlaknuti	V;PRS;NOM(1;SG)	odlaknem
doprijeti	V;PRS;NOM(1;SG)	doprem
ižvakati	V;PRS;NOM(1;SG)	ižvakam
zanijekati	V;PRS;NOM(1;SG)	zaničem
zapeći	V;PRS;NOM(1;SG)	zapečem
moći	V;PRS;NOM(1;SG)	mognem
narisati	V;PRS;NOM(1;SG)	narišem
nanijeti	V;PRS;NOM(1;SG)	nanesem
preokretati	V;PRS;NOM(1;SG)	preokrećem
klopotati	V;PRS;NOM(1;SG)	klopotam
doseći	V;PRS;NOM(1;SG)	doseknem
protepsti	V;PRS;NOM(1;SG)	protebem
snaći	V;PRS;NOM(1;SG)	snađem
razvezati	V;PRS;NOM(1;SG)	razvežem
dostići	V;PRS;NOM(1;SG)	dostignem
greznuti	V;PRS;NOM(1;SG)	greznem
okrznuti	V;PRS;NOM(1;SG)	okrznem
saprati	V;PRS;NOM(1;SG)	saperem
pjevnuti	V;PRS;NOM(1;SG)	pjevnem
zavrgnuti	V;PRS;NOM(1;SG)	zavrgnem
obrtati	V;PRS;NOM(1;SG)	obrtam
poći	V;PRS;NOM(1;SG)	pognem
prerasti	V;PRS;NOM(1;SG)	prerastem
obamrijeti	V;PRS;NOM(1;SG)	obamrem
odapeti	V;PRS;NOM(1;SG)	odapnem
sjesti	V;PRS;NOM(1;SG)	sjednem
nakresati	V;PRS;NOM(1;SG)	nakrešem
zateći	V;PRS;NOM(1;SG)	zatekem
pomirisati	V;PRS;NOM(1;SG)	pomirišem
postati	V;PRS;NOM(1;SG)	postajem
klizati	V;PRS;NOM(1;SG)	klizam
minuti	V;PRS;NOM(1;SG)	minem
prasnuti	V;PRS;NOM(1;SG)	prasnem
trenuti	V;PRS;NOM(1;SG)	trenem
izokretati	V;PRS;NOM(1;SG)	izokrećem
zamahnuti	V;PRS;NOM(1;SG)	zamahnem
poderati	V;PRS;NOM(1;SG)	poderam
utrnuti	V;PRS;NOM(1;SG)	utrnem
uprijeti	V;PRS;NOM(1;SG)	uprem
primicati	V;PRS;NOM(1;SG)	primičem
iskazati	V;PRS;NOM(1;SG)	iskažem
izorati	V;PRS;NOM(1;SG)	izorem
zajesti	V;PRS;NOM(1;SG)	zajedem
prevagnuti	V;PRS;NOM(1;SG)	prevagnem
virnuti	V;PRS;NOM(1;SG)	virnem
lizati	V;PRS;NOM(1;SG)	ližem
nasuti	V;PRS;NOM(1;SG)	naspem
