meliorirati	V;PRS;NOM(3;SG)	melioriram
filtrirati	V;PRS;NOM(3;SG)	filtriram
sklepati	V;PRS;NOM(3;SG)	sklepam
ukrućivati	V;PRS;NOM(3;SG)	ukrućivam
instalirati	V;PRS;NOM(3;SG)	instaliram
dozidati	V;PRS;NOM(3;SG)	dozidam
promozgati	V;PRS;NOM(3;SG)	promozgam
proventilirati	V;PRS;NOM(3;SG)	proventiliram
pokuljati	V;PRS;NOM(3;SG)	pokuljam
odmarati	V;PRS;NOM(3;SG)	odmaram
oporezivati	V;PRS;NOM(3;SG)	oporezivam
ispunjati	V;PRS;NOM(3;SG)	ispunjam
monopolizirati	V;PRS;NOM(3;SG)	monopoliziram
markirati	V;PRS;NOM(3;SG)	markiram
fascinirati	V;PRS;NOM(3;SG)	fasciniram
fantazirati	V;PRS;NOM(3;SG)	fantaziram
zakašnjavati	V;PRS;NOM(3;SG)	zakašnjavam
opčaravati	V;PRS;NOM(3;SG)	opčaravam
naglašavati	V;PRS;NOM(3;SG)	naglašavam
larmati	V;PRS;NOM(3;SG)	larmam
akcelerirati	V;PRS;NOM(3;SG)	akceleriram
ukopati	V;PRS;NOM(3;SG)	ukopam
gađati	V;PRS;NOM(3;SG)	gađam
nabubati	V;PRS;NOM(3;SG)	nabubam
konstatirati	V;PRS;NOM(3;SG)	konstatiram
izblanjati	V;PRS;NOM(3;SG)	izblanjam
gatati	V;PRS;NOM(3;SG)	gatam
boldati	V;PRS;NOM(3;SG)	boldam
odrpati	V;PRS;NOM(3;SG)	odrpam
prepadati	V;PRS;NOM(3;SG)	prepadam
opadati	V;PRS;NOM(3;SG)	opadam
prelistati	V;PRS;NOM(3;SG)	prelistam
isjeckati	V;PRS;NOM(3;SG)	isjeckam
upetljavati	V;PRS;NOM(3;SG)	upetljavam
zamišljati	V;PRS;NOM(3;SG)	zamišljam
obredati	V;PRS;NOM(3;SG)	obredam
oduzimati	V;PRS;NOM(3;SG)	oduzimam
bagatelizirati	V;PRS;NOM(3;SG)	bagateliziram
šunjati	V;PRS;NOM(3;SG)	šunjam
prolunjati	V;PRS;NOM(3;SG)	prolunjam
žicati	V;PRS;NOM(3;SG)	žicam
sašaptavati	V;PRS;NOM(3;SG)	sašaptavam
prihvaćati	V;PRS;NOM(3;SG)	prihvaćam
demantirati	V;PRS;NOM(3;SG)	demantiram
muvati	V;PRS;NOM(3;SG)	muvam
zagarantirati	V;PRS;NOM(3;SG)	zagarantiram
skrivati	V;PRS;NOM(3;SG)	skrivam
skotrljati	V;PRS;NOM(3;SG)	skotrljam
lansirati	V;PRS;NOM(3;SG)	lansiram
zaveslati	V;PRS;NOM(3;SG)	zaveslam
švrljati	V;PRS;NOM(3;SG)	švrljam
sklanjati	V;PRS;NOM(3;SG)	sklanjam
otpravljati	V;PRS;NOM(3;SG)	otpravljam
izmišljati	V;PRS;NOM(3;SG)	izmišljam
ispumpati	V;PRS;NOM(3;SG)	ispumpam
varirati	V;PRS;NOM(3;SG)	variram
skidati	V;PRS;NOM(3;SG)	skidam
reorganizirati	V;PRS;NOM(3;SG)	reorganiziram
pojačati	V;PRS;NOM(3;SG)	pojačam
zbrinjavati	V;PRS;NOM(3;SG)	zbrinjavam
koordinirati	V;PRS;NOM(3;SG)	koordiniram
zaviđati	V;PRS;NOM(3;SG)	zaviđam
kljucati	V;PRS;NOM(3;SG)	kljucam
odgađati	V;PRS;NOM(3;SG)	odgađam
lickati	V;PRS;NOM(3;SG)	lickam
zatrebati	V;PRS;NOM(3;SG)	zatrebam
pirkati	V;PRS;NOM(3;SG)	pirkam
pridrijemati	V;PRS;NOM(3;SG)	pridrijemam
normirati	V;PRS;NOM(3;SG)	normiram
dodijavati	V;PRS;NOM(3;SG)	dodijavam
oslikati	V;PRS;NOM(3;SG)	oslikam
zadijevati	V;PRS;NOM(3;SG)	zadijevam
domunđavati	V;PRS;NOM(3;SG)	domunđavam
nećkati	V;PRS;NOM(3;SG)	nećkam
porječkati	V;PRS;NOM(3;SG)	porječkam
reprizirati	V;PRS;NOM(3;SG)	repriziram
nagovarati	V;PRS;NOM(3;SG)	nagovaram
drijemati	V;PRS;NOM(3;SG)	drijemam
pročitati	V;PRS;NOM(3;SG)	pročitam
izmotati	V;PRS;NOM(3;SG)	izmotam
licitirati	V;PRS;NOM(3;SG)	licitiram
zalutati	V;PRS;NOM(3;SG)	zalutam
gužvati	V;PRS;NOM(3;SG)	gužvam
obilježavati	V;PRS;NOM(3;SG)	obilježavam
jačati	V;PRS;NOM(3;SG)	jačam
nacijepati	V;PRS;NOM(3;SG)	nacijepam
pacificirati	V;PRS;NOM(3;SG)	pacificiram
nagađati	V;PRS;NOM(3;SG)	nagađam
valjati	V;PRS;NOM(3;SG)	valjam
potapati	V;PRS;NOM(3;SG)	potapam
ukidati	V;PRS;NOM(3;SG)	ukidam
prevladati	V;PRS;NOM(3;SG)	prevladam
pokusati	V;PRS;NOM(3;SG)	pokusam
isprekidati	V;PRS;NOM(3;SG)	isprekidam
birokratizirati	V;PRS;NOM(3;SG)	birokratiziram
doimati	V;PRS;NOM(3;SG)	doimam
naciljati	V;PRS;NOM(3;SG)	naciljam
sudarati	V;PRS;NOM(3;SG)	sudaram
krzati	V;PRS;NOM(3;SG)	krzam
furnirati	V;PRS;NOM(3;SG)	furniram
pohvatati	V;PRS;NOM(3;SG)	pohvatam
penjati	V;PRS;NOM(3;SG)	penjam
morati	V;PRS;NOM(3;SG)	moram
kusati	V;PRS;NOM(3;SG)	kusam
razgovarati	V;PRS;NOM(3;SG)	razgovaram
povjeravati	V;PRS;NOM(3;SG)	povjeravam
revalorizirati	V;PRS;NOM(3;SG)	revaloriziram
malaksavati	V;PRS;NOM(3;SG)	malaksavam
oporavljati	V;PRS;NOM(3;SG)	oporavljam
secirati	V;PRS;NOM(3;SG)	seciram
neutralizirati	V;PRS;NOM(3;SG)	neutraliziram
češljati	V;PRS;NOM(3;SG)	češljam
prolamati	V;PRS;NOM(3;SG)	prolamam
gunđati	V;PRS;NOM(3;SG)	gunđam
razmještati	V;PRS;NOM(3;SG)	razmještam
apostrofirati	V;PRS;NOM(3;SG)	apostrofiram
ekshumirati	V;PRS;NOM(3;SG)	ekshumiram
odudarati	V;PRS;NOM(3;SG)	odudaram
zakovzčati	V;PRS;NOM(3;SG)	zakovzčam
isprobavati	V;PRS;NOM(3;SG)	isprobavam
spiskati	V;PRS;NOM(3;SG)	spiskam
pasirati	V;PRS;NOM(3;SG)	pasiram
zaklanjati	V;PRS;NOM(3;SG)	zaklanjam
figurirati	V;PRS;NOM(3;SG)	figuriram
uništavati	V;PRS;NOM(3;SG)	uništavam
zakapčati	V;PRS;NOM(3;SG)	zakapčam
odmotavati	V;PRS;NOM(3;SG)	odmotavam
preispitati	V;PRS;NOM(3;SG)	preispitam
pumpati	V;PRS;NOM(3;SG)	pumpam
evakuirati	V;PRS;NOM(3;SG)	evakuiram
piturati	V;PRS;NOM(3;SG)	pituram
apstinirati	V;PRS;NOM(3;SG)	apstiniram
oponašati	V;PRS;NOM(3;SG)	oponašam
zadržavati	V;PRS;NOM(3;SG)	zadržavam
ispovijedati	V;PRS;NOM(3;SG)	ispovijedam
lamatati	V;PRS;NOM(3;SG)	lamatam
zatjerati	V;PRS;NOM(3;SG)	zatjeram
cvikati	V;PRS;NOM(3;SG)	cvikam
brukati	V;PRS;NOM(3;SG)	brukam
izigravati	V;PRS;NOM(3;SG)	izigravam
praskati	V;PRS;NOM(3;SG)	praskam
nadrljati	V;PRS;NOM(3;SG)	nadrljam
stipendirati	V;PRS;NOM(3;SG)	stipendiram
centrirati	V;PRS;NOM(3;SG)	centriram
žmirkati	V;PRS;NOM(3;SG)	žmirkam
opljačkati	V;PRS;NOM(3;SG)	opljačkam
trgati	V;PRS;NOM(3;SG)	trgam
operirati	V;PRS;NOM(3;SG)	operiram
valorizirati	V;PRS;NOM(3;SG)	valoriziram
napuhavati	V;PRS;NOM(3;SG)	napuhavam
ispovraćati	V;PRS;NOM(3;SG)	ispovraćam
ogovarati	V;PRS;NOM(3;SG)	ogovaram
glazirati	V;PRS;NOM(3;SG)	glaziram
iščupati	V;PRS;NOM(3;SG)	iščupam
škljocati	V;PRS;NOM(3;SG)	škljocam
grgutati	V;PRS;NOM(3;SG)	grgutam
posakrivati	V;PRS;NOM(3;SG)	posakrivam
opjevati	V;PRS;NOM(3;SG)	opjevam
reterirati	V;PRS;NOM(3;SG)	reteriram
razvijati	V;PRS;NOM(3;SG)	razvijam
ustrebati	V;PRS;NOM(3;SG)	ustrebam
šibati	V;PRS;NOM(3;SG)	šibam
natjeravati	V;PRS;NOM(3;SG)	natjeravam
blanjati	V;PRS;NOM(3;SG)	blanjam
ismijavati	V;PRS;NOM(3;SG)	ismijavam
smežurati	V;PRS;NOM(3;SG)	smežuram
smjerati	V;PRS;NOM(3;SG)	smjeram
ždrijebati	V;PRS;NOM(3;SG)	ždrijebam
ogledati	V;PRS;NOM(3;SG)	ogledam
prodiskutirati	V;PRS;NOM(3;SG)	prodiskutiram
ocrnjivati	V;PRS;NOM(3;SG)	ocrnjivam
uspijevati	V;PRS;NOM(3;SG)	uspijevam
izravnati	V;PRS;NOM(3;SG)	izravnam
otvarati	V;PRS;NOM(3;SG)	otvaram
ištrcati	V;PRS;NOM(3;SG)	ištrcam
smijuckati	V;PRS;NOM(3;SG)	smijuckam
rastjerati	V;PRS;NOM(3;SG)	rastjeram
istjeravati	V;PRS;NOM(3;SG)	istjeravam
ekavizirati	V;PRS;NOM(3;SG)	ekaviziram
ubrzati	V;PRS;NOM(3;SG)	ubrzam
obasjavati	V;PRS;NOM(3;SG)	obasjavam
idealizirati	V;PRS;NOM(3;SG)	idealiziram
očitavati	V;PRS;NOM(3;SG)	očitavam
asfaltirati	V;PRS;NOM(3;SG)	asfaltiram
zaintrigirati	V;PRS;NOM(3;SG)	zaintrigiram
brigati	V;PRS;NOM(3;SG)	brigam
izgurati	V;PRS;NOM(3;SG)	izguram
zanimati	V;PRS;NOM(3;SG)	zanimam
protumarati	V;PRS;NOM(3;SG)	protumaram
provocirati	V;PRS;NOM(3;SG)	provociram
otkopčati	V;PRS;NOM(3;SG)	otkopčam
pogledavati	V;PRS;NOM(3;SG)	pogledavam
krcati	V;PRS;NOM(3;SG)	krcam
sjedati	V;PRS;NOM(3;SG)	sjedam
kritizirati	V;PRS;NOM(3;SG)	kritiziram
razlistati	V;PRS;NOM(3;SG)	razlistam
prokušati	V;PRS;NOM(3;SG)	prokušam
škripati	V;PRS;NOM(3;SG)	škripam
isklijati	V;PRS;NOM(3;SG)	isklijam
brljati	V;PRS;NOM(3;SG)	brljam
kockati	V;PRS;NOM(3;SG)	kockam
plakatirati	V;PRS;NOM(3;SG)	plakatiram
zateturati	V;PRS;NOM(3;SG)	zateturam
stopirati	V;PRS;NOM(3;SG)	stopiram
cuclati	V;PRS;NOM(3;SG)	cuclam
pribijati	V;PRS;NOM(3;SG)	pribijam
poimati	V;PRS;NOM(3;SG)	poimam
likvidirati	V;PRS;NOM(3;SG)	likvidiram
ekipirati	V;PRS;NOM(3;SG)	ekipiram
pucati	V;PRS;NOM(3;SG)	pucam
grebenati	V;PRS;NOM(3;SG)	grebenam
odagnati	V;PRS;NOM(3;SG)	odagnam
rasprčkati	V;PRS;NOM(3;SG)	rasprčkam
zablistati	V;PRS;NOM(3;SG)	zablistam
kompenzirati	V;PRS;NOM(3;SG)	kompenziram
animirati	V;PRS;NOM(3;SG)	animiram
palucati	V;PRS;NOM(3;SG)	palucam
šepati	V;PRS;NOM(3;SG)	šepam
tapkati	V;PRS;NOM(3;SG)	tapkam
zadaviti	V;PRS;NOM(3;SG)	zadavim
planinariti	V;PRS;NOM(3;SG)	planinarim
ostvariti	V;PRS;NOM(3;SG)	ostvarim
rogoboriti	V;PRS;NOM(3;SG)	rogoborim
naheriti	V;PRS;NOM(3;SG)	naherim
udvojiti	V;PRS;NOM(3;SG)	udvojim
ohrapaviti	V;PRS;NOM(3;SG)	ohrapavim
prekipjeti	V;PRS;NOM(3;SG)	prekipjmem
vrpoljiti	V;PRS;NOM(3;SG)	vrpoljim
posoliti	V;PRS;NOM(3;SG)	posolim
otkačiti	V;PRS;NOM(3;SG)	otkačim
zakukuljiti	V;PRS;NOM(3;SG)	zakukuljim
izvjesiti	V;PRS;NOM(3;SG)	izvjesim
vabiti	V;PRS;NOM(3;SG)	vabim
odmijeniti	V;PRS;NOM(3;SG)	odmijenim
zaljubiti	V;PRS;NOM(3;SG)	zaljubim
naletjeti	V;PRS;NOM(3;SG)	naletjmem
dovabiti	V;PRS;NOM(3;SG)	dovabim
miriti	V;PRS;NOM(3;SG)	mirim
moliti	V;PRS;NOM(3;SG)	molim
driješiti	V;PRS;NOM(3;SG)	driješim
predstaviti	V;PRS;NOM(3;SG)	predstavim
zakositi	V;PRS;NOM(3;SG)	zakosim
podvaliti	V;PRS;NOM(3;SG)	podvalim
ovapnjeti	V;PRS;NOM(3;SG)	ovapnjmem
omalovažiti	V;PRS;NOM(3;SG)	omalovažim
natovariti	V;PRS;NOM(3;SG)	natovarim
iskipjeti	V;PRS;NOM(3;SG)	iskipjmem
udaljiti	V;PRS;NOM(3;SG)	udaljim
shvatiti	V;PRS;NOM(3;SG)	shvatim
objaviti	V;PRS;NOM(3;SG)	objavim
raščlaniti	V;PRS;NOM(3;SG)	raščlanim
zamastiti	V;PRS;NOM(3;SG)	zamastsem
gnjiliti	V;PRS;NOM(3;SG)	gnjilim
pomutiti	V;PRS;NOM(3;SG)	pomutmem
pretovariti	V;PRS;NOM(3;SG)	pretovarim
posvojiti	V;PRS;NOM(3;SG)	posvojim
jamčiti	V;PRS;NOM(3;SG)	jamčim
vaditi	V;PRS;NOM(3;SG)	vadim
popratiti	V;PRS;NOM(3;SG)	popratim
istrijebiti	V;PRS;NOM(3;SG)	istrijebim
učiniti	V;PRS;NOM(3;SG)	učinim
dolaziti	V;PRS;NOM(3;SG)	dolazim
izbezumiti	V;PRS;NOM(3;SG)	izbezumim
podvoditi	V;PRS;NOM(3;SG)	podvodim
ostarjeti	V;PRS;NOM(3;SG)	ostarjmem
premašiti	V;PRS;NOM(3;SG)	premašim
štaviti	V;PRS;NOM(3;SG)	štavim
zapaliti	V;PRS;NOM(3;SG)	zapalim
zamisliti	V;PRS;NOM(3;SG)	zamislim
znojiti	V;PRS;NOM(3;SG)	znojim
vjeriti	V;PRS;NOM(3;SG)	vjerim
upozoriti	V;PRS;NOM(3;SG)	upozorim
nagoniti	V;PRS;NOM(3;SG)	nagonim
plamtjeti	V;PRS;NOM(3;SG)	plamtjmem
ogaditi	V;PRS;NOM(3;SG)	ogadim
blejati	V;PRS;NOM(3;SG)	blejam
obilježiti	V;PRS;NOM(3;SG)	obilježim
uroditi	V;PRS;NOM(3;SG)	urodim
podilaziti	V;PRS;NOM(3;SG)	podilazim
boraviti	V;PRS;NOM(3;SG)	boravim
odnaroditi	V;PRS;NOM(3;SG)	odnarodim
zadrhtjeti	V;PRS;NOM(3;SG)	zadrhtjmem
osamiti	V;PRS;NOM(3;SG)	osamim
plastiti	V;PRS;NOM(3;SG)	plastsem
nakinđuriti	V;PRS;NOM(3;SG)	nakinđurim
iščašiti	V;PRS;NOM(3;SG)	iščašim
projuriti	V;PRS;NOM(3;SG)	projurim
probaviti	V;PRS;NOM(3;SG)	probavim
razvedriti	V;PRS;NOM(3;SG)	razvedrim
trošiti	V;PRS;NOM(3;SG)	trošim
učvrstiti	V;PRS;NOM(3;SG)	učvrstsem
pomrsiti	V;PRS;NOM(3;SG)	pomrsim
ukrotiti	V;PRS;NOM(3;SG)	ukrotim
povratiti	V;PRS;NOM(3;SG)	povratim
previdjeti	V;PRS;NOM(3;SG)	previdjmem
othraniti	V;PRS;NOM(3;SG)	othranim
zatomiti	V;PRS;NOM(3;SG)	zatomim
obdariti	V;PRS;NOM(3;SG)	obdarim
porazgovoriti	V;PRS;NOM(3;SG)	porazgovorim
odlučiti	V;PRS;NOM(3;SG)	odlučim
izrezbariti	V;PRS;NOM(3;SG)	izrezbarim
čuditi	V;PRS;NOM(3;SG)	čudim
otvoriti	V;PRS;NOM(3;SG)	otvorim
nagoditi	V;PRS;NOM(3;SG)	nagodim
nasamariti	V;PRS;NOM(3;SG)	nasamarim
oćelaviti	V;PRS;NOM(3;SG)	oćelavim
uprtiti	V;PRS;NOM(3;SG)	uprtim
graničiti	V;PRS;NOM(3;SG)	graničim
truditi	V;PRS;NOM(3;SG)	trudim
pojaviti	V;PRS;NOM(3;SG)	pojavim
zaprijetiti	V;PRS;NOM(3;SG)	zaprem
govoriti	V;PRS;NOM(3;SG)	govorim
opustjeti	V;PRS;NOM(3;SG)	opustjmem
mzštiti	V;PRS;NOM(3;SG)	mzštim
utrapiti	V;PRS;NOM(3;SG)	utrapim
razjuriti	V;PRS;NOM(3;SG)	razjurim
bludjeti	V;PRS;NOM(3;SG)	bludjmem
razdvojiti	V;PRS;NOM(3;SG)	razdvojim
odvaliti	V;PRS;NOM(3;SG)	odvalim
meškoljiti	V;PRS;NOM(3;SG)	meškoljim
nasmiješiti	V;PRS;NOM(3;SG)	nasmiješim
zašećeriti	V;PRS;NOM(3;SG)	zašećerim
rovariti	V;PRS;NOM(3;SG)	rovarim
našaliti	V;PRS;NOM(3;SG)	našalim
sivjeti	V;PRS;NOM(3;SG)	sivjmem
prašiti	V;PRS;NOM(3;SG)	prašim
mrviti	V;PRS;NOM(3;SG)	mrvim
dogoditi	V;PRS;NOM(3;SG)	dogodim
slutiti	V;PRS;NOM(3;SG)	slutmem
navoditi	V;PRS;NOM(3;SG)	navodim
mašiti	V;PRS;NOM(3;SG)	mašim
rascijepiti	V;PRS;NOM(3;SG)	rascijepim
opraviti	V;PRS;NOM(3;SG)	opravim
otkloniti	V;PRS;NOM(3;SG)	otklonim
zgromiti	V;PRS;NOM(3;SG)	zgromim
zoriti	V;PRS;NOM(3;SG)	zorim
ohladiti	V;PRS;NOM(3;SG)	ohladim
podjarmiti	V;PRS;NOM(3;SG)	podjarmim
utrošiti	V;PRS;NOM(3;SG)	utrošim
vratiti	V;PRS;NOM(3;SG)	vratim
počiniti	V;PRS;NOM(3;SG)	počinim
brzojaviti	V;PRS;NOM(3;SG)	brzojavim
opunomoćiti	V;PRS;NOM(3;SG)	opunomoćikem
nadojiti	V;PRS;NOM(3;SG)	nadojim
pospremiti	V;PRS;NOM(3;SG)	pospremim
izbušiti	V;PRS;NOM(3;SG)	izbušim
uskladiti	V;PRS;NOM(3;SG)	uskladim
tupiti	V;PRS;NOM(3;SG)	tupim
unazaditi	V;PRS;NOM(3;SG)	unazadim
naoštriti	V;PRS;NOM(3;SG)	naoštrim
ozakoniti	V;PRS;NOM(3;SG)	ozakonim
izlomiti	V;PRS;NOM(3;SG)	izlomim
položiti	V;PRS;NOM(3;SG)	položim
zalediti	V;PRS;NOM(3;SG)	zaledim
usvojiti	V;PRS;NOM(3;SG)	usvojim
nastrijeliti	V;PRS;NOM(3;SG)	nastrijelim
ljubiti	V;PRS;NOM(3;SG)	ljubim
obletjeti	V;PRS;NOM(3;SG)	obletjmem
pognojiti	V;PRS;NOM(3;SG)	pognojim
pobojati	V;PRS;NOM(3;SG)	pobojam
oroditi	V;PRS;NOM(3;SG)	orodim
povjeriti	V;PRS;NOM(3;SG)	povjerim
obojiti	V;PRS;NOM(3;SG)	obojim
zazvučati	V;PRS;NOM(3;SG)	zazvučam
prilagoditi	V;PRS;NOM(3;SG)	prilagodim
ustanoviti	V;PRS;NOM(3;SG)	ustanovim
zapriječiti	V;PRS;NOM(3;SG)	zapriječim
potpiriti	V;PRS;NOM(3;SG)	potpirim
sagraditi	V;PRS;NOM(3;SG)	sagradim
podičiti	V;PRS;NOM(3;SG)	podičim
konačiti	V;PRS;NOM(3;SG)	konačim
sljepariti	V;PRS;NOM(3;SG)	sljeparim
predaniti	V;PRS;NOM(3;SG)	predanim
tamaniti	V;PRS;NOM(3;SG)	tamanim
nadrediti	V;PRS;NOM(3;SG)	nadredim
zgoniti	V;PRS;NOM(3;SG)	zgonim
tetošiti	V;PRS;NOM(3;SG)	tetošim
povaditi	V;PRS;NOM(3;SG)	povadim
zakrčiti	V;PRS;NOM(3;SG)	zakrčim
dogorjeti	V;PRS;NOM(3;SG)	dogorjmem
seliti	V;PRS;NOM(3;SG)	selim
raskalašiti	V;PRS;NOM(3;SG)	raskalašim
suzdržati	V;PRS;NOM(3;SG)	suzdržam
iskzstiti	V;PRS;NOM(3;SG)	iskzstsem
odglumiti	V;PRS;NOM(3;SG)	odglumim
loviti	V;PRS;NOM(3;SG)	lovim
treperiti	V;PRS;NOM(3;SG)	treperim
njušiti	V;PRS;NOM(3;SG)	njušim
namijeniti	V;PRS;NOM(3;SG)	namijenim
ishoditi	V;PRS;NOM(3;SG)	ishodim
upraviti	V;PRS;NOM(3;SG)	upravim
tumačiti	V;PRS;NOM(3;SG)	tumačim
zguliti	V;PRS;NOM(3;SG)	zgulim
odbrojiti	V;PRS;NOM(3;SG)	odbrojim
pogostiti	V;PRS;NOM(3;SG)	pogostsem
probesjediti	V;PRS;NOM(3;SG)	probesjedim
cviljeti	V;PRS;NOM(3;SG)	cviljmem
suziti	V;PRS;NOM(3;SG)	suzim
okotiti	V;PRS;NOM(3;SG)	okotim
prešutjeti	V;PRS;NOM(3;SG)	prešutjmem
smršaviti	V;PRS;NOM(3;SG)	smršavim
ovisiti	V;PRS;NOM(3;SG)	ovisim
sjediniti	V;PRS;NOM(3;SG)	sjedinim
ošepaviti	V;PRS;NOM(3;SG)	ošepavim
baviti	V;PRS;NOM(3;SG)	bavim
predodrediti	V;PRS;NOM(3;SG)	predodredim
posvetiti	V;PRS;NOM(3;SG)	posvetmem
osladiti	V;PRS;NOM(3;SG)	osladim
raspolutiti	V;PRS;NOM(3;SG)	raspolutmem
prepoloviti	V;PRS;NOM(3;SG)	prepolovim
budaliti	V;PRS;NOM(3;SG)	budalim
porazmisliti	V;PRS;NOM(3;SG)	porazmislim
grgoriti	V;PRS;NOM(3;SG)	grgorim
zaprositi	V;PRS;NOM(3;SG)	zaprosim
poraniti	V;PRS;NOM(3;SG)	poranim
kvariti	V;PRS;NOM(3;SG)	kvarim
pooštriti	V;PRS;NOM(3;SG)	pooštrim
raspomamiti	V;PRS;NOM(3;SG)	raspomamim
udesiti	V;PRS;NOM(3;SG)	udesim
zaratiti	V;PRS;NOM(3;SG)	zaratim
trčati	V;PRS;NOM(3;SG)	trčam
smlaviti	V;PRS;NOM(3;SG)	smlavim
odjedriti	V;PRS;NOM(3;SG)	odjedrim
isturiti	V;PRS;NOM(3;SG)	isturim
poštedjeti	V;PRS;NOM(3;SG)	poštedjmem
odšarafiti	V;PRS;NOM(3;SG)	odšarafim
gramziti	V;PRS;NOM(3;SG)	gramzim
mraziti	V;PRS;NOM(3;SG)	mrazim
kućiti	V;PRS;NOM(3;SG)	kućikem
tovariti	V;PRS;NOM(3;SG)	tovarim
skladištiti	V;PRS;NOM(3;SG)	skladištim
osnovati	V;PRS;NOM(3;SG)	osnovam
iscjeljivati	V;PRS;NOM(3;SG)	iscjeljivam
uperivati	V;PRS;NOM(3;SG)	uperivam
posvjetljivati	V;PRS;NOM(3;SG)	posvjetljivam
požeti	V;PRS;NOM(3;SG)	požmem
namirivati	V;PRS;NOM(3;SG)	namirivam
negodovati	V;PRS;NOM(3;SG)	negodovam
svetkovati	V;PRS;NOM(3;SG)	svetkovam
dojavljivati	V;PRS;NOM(3;SG)	dojavljivam
izažimati	V;PRS;NOM(3;SG)	izažimam
pretkazivati	V;PRS;NOM(3;SG)	pretkazivam
podrugivati	V;PRS;NOM(3;SG)	podrugivam
prouzročivati	V;PRS;NOM(3;SG)	prouzročivam
opljevljivati	V;PRS;NOM(3;SG)	opljevljivam
izaslati	V;PRS;NOM(3;SG)	izaslam
popiti	V;PRS;NOM(3;SG)	popim
razmrsivati	V;PRS;NOM(3;SG)	razmrsivam
umanjivati	V;PRS;NOM(3;SG)	umanjivam
prorovati	V;PRS;NOM(3;SG)	prorovam
bivstvovati	V;PRS;NOM(3;SG)	bivstvovam
pozajmljivati	V;PRS;NOM(3;SG)	pozajmljivam
carevati	V;PRS;NOM(3;SG)	carevam
pocupkivati	V;PRS;NOM(3;SG)	pocupkivam
stolovati	V;PRS;NOM(3;SG)	stolovam
zadirkivati	V;PRS;NOM(3;SG)	zadirkivam
otkazivati	V;PRS;NOM(3;SG)	otkazivam
okuraživati	V;PRS;NOM(3;SG)	okuraživam
ublaživati	V;PRS;NOM(3;SG)	ublaživam
nadraživati	V;PRS;NOM(3;SG)	nadraživam
posvećivati	V;PRS;NOM(3;SG)	posvećivam
odrađivati	V;PRS;NOM(3;SG)	odrađivam
posredovati	V;PRS;NOM(3;SG)	posredovam
otkvačivati	V;PRS;NOM(3;SG)	otkvačivam
zaleđivati	V;PRS;NOM(3;SG)	zaleđivam
opsluživati	V;PRS;NOM(3;SG)	opsluživam
rastajati	V;PRS;NOM(3;SG)	rastajam
rasuđivati	V;PRS;NOM(3;SG)	rasuđivam
sudjelovati	V;PRS;NOM(3;SG)	sudjelovam
napredovati	V;PRS;NOM(3;SG)	napredovam
udjeljivati	V;PRS;NOM(3;SG)	udjeljivam
potpaljivati	V;PRS;NOM(3;SG)	potpaljivam
razumjeti	V;PRS;NOM(3;SG)	razumjmem
razljućivati	V;PRS;NOM(3;SG)	razljućivam
šegrtovati	V;PRS;NOM(3;SG)	šegrtovam
nagrađivati	V;PRS;NOM(3;SG)	nagrađivam
srbovati	V;PRS;NOM(3;SG)	srbovam
priljubljivati	V;PRS;NOM(3;SG)	priljubljivam
izdubljivati	V;PRS;NOM(3;SG)	izdubljivam
ozljeđivati	V;PRS;NOM(3;SG)	ozljeđivam
zaliti	V;PRS;NOM(3;SG)	zalim
rasterećivati	V;PRS;NOM(3;SG)	rasterećivam
obujmljivati	V;PRS;NOM(3;SG)	obujmljivam
glasovati	V;PRS;NOM(3;SG)	glasovam
podavati	V;PRS;NOM(3;SG)	podavam
obeshrabrivati	V;PRS;NOM(3;SG)	obeshrabrivam
smijati	V;PRS;NOM(3;SG)	smijam
raspodjeljivati	V;PRS;NOM(3;SG)	raspodjeljivam
donaliti	V;PRS;NOM(3;SG)	donalim
vjerovati	V;PRS;NOM(3;SG)	vjerovam
uglađivati	V;PRS;NOM(3;SG)	uglađivam
nasljeđivati	V;PRS;NOM(3;SG)	nasljeđivam
radovati	V;PRS;NOM(3;SG)	radovam
zatupljivati	V;PRS;NOM(3;SG)	zatupljivam
vrbovati	V;PRS;NOM(3;SG)	vrbovam
opsjenjivati	V;PRS;NOM(3;SG)	opsjenjivam
razlučivati	V;PRS;NOM(3;SG)	razlučivam
putovati	V;PRS;NOM(3;SG)	putovam
posuđivati	V;PRS;NOM(3;SG)	posuđivam
slati	V;PRS;NOM(3;SG)	slam
zamazati	V;PRS;NOM(3;SG)	zamazam
ostrići	V;PRS;NOM(3;SG)	ostrikem
zasjeći	V;PRS;NOM(3;SG)	zasjekem
utaknuti	V;PRS;NOM(3;SG)	utaknem
previrati	V;PRS;NOM(3;SG)	previram
nadlijetati	V;PRS;NOM(3;SG)	nadlijetam
zaogrnuti	V;PRS;NOM(3;SG)	zaogrnem
grmnuti	V;PRS;NOM(3;SG)	grmnem
puziti	V;PRS;NOM(3;SG)	puzim
smetnuti	V;PRS;NOM(3;SG)	smetnem
orezati	V;PRS;NOM(3;SG)	orezam
ustati	V;PRS;NOM(3;SG)	ustam
polegnuti	V;PRS;NOM(3;SG)	polegnem
kliznuti	V;PRS;NOM(3;SG)	kliznem
obasuti	V;PRS;NOM(3;SG)	obasmem
plesti	V;PRS;NOM(3;SG)	plesem
protrti	V;PRS;NOM(3;SG)	protrem
šuknuti	V;PRS;NOM(3;SG)	šuknem
izmetnuti	V;PRS;NOM(3;SG)	izmetnem
klipsati	V;PRS;NOM(3;SG)	klipsam
isprati	V;PRS;NOM(3;SG)	ispram
splesti	V;PRS;NOM(3;SG)	splesem
utrti	V;PRS;NOM(3;SG)	utrem
skresati	V;PRS;NOM(3;SG)	skresam
liptati	V;PRS;NOM(3;SG)	liptam
odreći	V;PRS;NOM(3;SG)	odrekem
pomicati	V;PRS;NOM(3;SG)	pomicam
nicati	V;PRS;NOM(3;SG)	nicam
izgristi	V;PRS;NOM(3;SG)	izgrisem
vrisnuti	V;PRS;NOM(3;SG)	vrisnem
pomrijeti	V;PRS;NOM(3;SG)	pomrem
dotjecati	V;PRS;NOM(3;SG)	dotjecam
nabreknuti	V;PRS;NOM(3;SG)	nabreknem
dotepsti	V;PRS;NOM(3;SG)	dotenem
opozvati	V;PRS;NOM(3;SG)	opozvam
raspuhati	V;PRS;NOM(3;SG)	raspuham
kriknuti	V;PRS;NOM(3;SG)	kriknem
izabirati	V;PRS;NOM(3;SG)	izabiram
pritisnuti	V;PRS;NOM(3;SG)	pritisnem
skretati	V;PRS;NOM(3;SG)	skretam
isplahnuti	V;PRS;NOM(3;SG)	isplahnem
mimoići	V;PRS;NOM(3;SG)	mimoikem
podmazati	V;PRS;NOM(3;SG)	podmazam
porinuti	V;PRS;NOM(3;SG)	porinem
pljusnuti	V;PRS;NOM(3;SG)	pljusnem
prignuti	V;PRS;NOM(3;SG)	prignem
poslagati	V;PRS;NOM(3;SG)	poslagam
nijekati	V;PRS;NOM(3;SG)	nijekam
potegnuti	V;PRS;NOM(3;SG)	potegnem
pomusti	V;PRS;NOM(3;SG)	pomusem
šetati	V;PRS;NOM(3;SG)	šetam
ujahati	V;PRS;NOM(3;SG)	ujaham
bubnuti	V;PRS;NOM(3;SG)	bubnem
beknuti	V;PRS;NOM(3;SG)	beknem
nagrtati	V;PRS;NOM(3;SG)	nagrtam
spotaknuti	V;PRS;NOM(3;SG)	spotaknem
leći	V;PRS;NOM(3;SG)	lekem
tresnuti	V;PRS;NOM(3;SG)	tresnem
sklizati	V;PRS;NOM(3;SG)	sklizam
otrgnuti	V;PRS;NOM(3;SG)	otrgnem
potresti	V;PRS;NOM(3;SG)	potresem
trgnuti	V;PRS;NOM(3;SG)	trgnem
pretrnuti	V;PRS;NOM(3;SG)	pretrnem
zastirati	V;PRS;NOM(3;SG)	zastiram
zaškripnuti	V;PRS;NOM(3;SG)	zaškripnem
opsjesti	V;PRS;NOM(3;SG)	opsjesem
stići	V;PRS;NOM(3;SG)	stsem
cvokotati	V;PRS;NOM(3;SG)	cvokotam
počinuti	V;PRS;NOM(3;SG)	počinem
presuti	V;PRS;NOM(3;SG)	presmem
usahnuti	V;PRS;NOM(3;SG)	usahnem
posrnuti	V;PRS;NOM(3;SG)	posrnem
ispirati	V;PRS;NOM(3;SG)	ispiram
stati	V;PRS;NOM(3;SG)	stam
raspletati	V;PRS;NOM(3;SG)	raspletam
nadirati	V;PRS;NOM(3;SG)	nadiram
tvrdnuti	V;PRS;NOM(3;SG)	tvrdnem
grcnuti	V;PRS;NOM(3;SG)	grcnem
šiknuti	V;PRS;NOM(3;SG)	šiknem
osuti	V;PRS;NOM(3;SG)	osmem
proplanuti	V;PRS;NOM(3;SG)	proplanem
dorasti	V;PRS;NOM(3;SG)	dorasem
svanuti	V;PRS;NOM(3;SG)	svanem
poprati	V;PRS;NOM(3;SG)	popram
razmetati	V;PRS;NOM(3;SG)	razmetam
zaplesti	V;PRS;NOM(3;SG)	zaplesem
proisteći	V;PRS;NOM(3;SG)	proistekem
liznuti	V;PRS;NOM(3;SG)	liznem
pirnuti	V;PRS;NOM(3;SG)	pirnem
pojahati	V;PRS;NOM(3;SG)	pojaham
predskazati	V;PRS;NOM(3;SG)	predskazam
zarinuti	V;PRS;NOM(3;SG)	zarinem
grohotati	V;PRS;NOM(3;SG)	grohotam
riknuti	V;PRS;NOM(3;SG)	riknem
opuhnuti	V;PRS;NOM(3;SG)	opuhnem
predlagati	V;PRS;NOM(3;SG)	predlagam
privinuti	V;PRS;NOM(3;SG)	privinem
potpomoći	V;PRS;NOM(3;SG)	potpomokem
odisati	V;PRS;NOM(3;SG)	odisam
ubirati	V;PRS;NOM(3;SG)	ubiram
zapirati	V;PRS;NOM(3;SG)	zapiram
preuzeti	V;PRS;NOM(3;SG)	preuzmem
posrtati	V;PRS;NOM(3;SG)	posrtam
cvrkutati	V;PRS;NOM(3;SG)	cvrkutam
naprezati	V;PRS;NOM(3;SG)	naprezam
štrcnuti	V;PRS;NOM(3;SG)	štrcnem
prodrijeti	V;PRS;NOM(3;SG)	prodrem
tesati	V;PRS;NOM(3;SG)	tesam
podbosti	V;PRS;NOM(3;SG)	podbosem
